1111111111111111111111111111111111
1000P000000000000E0000C00000000011
1111111111111111111111111111111111