111111111111111111111111111111111111111111111111111111111111111111111
1C000000C00000000C000000C000000C000000C0000000C000000C000000C000000C1
101010010100101001010010100101001010010100101001010010100001010010101
101000000100000001000000010000000100000001000000010000000100000000101
101000000100000001000000010000000100000001000000010000000100000000101
1E000000C00000000C000000C000000C000000C0000000C000000C000000C000000C1
101010010100101001010010100101001010010100101001010010100101000010101
101000000100000001000000010000000100000001000000010000000100000000101
101000000100000001000000010000000100000001000000010000000100000000101
1P000000C00000000C000000C000000C000000C0000000C000000C000000C000000C1
111111111111111111111111111111111111111111111111111111111111111111111
